1,2,3,4,5,6,7,8,9,10
0,0,0,0,0,0,0,0,0,0,0
0,0,0,0,0,0,0,0,0,0,0
0,0,0,0,0,0,0,0,0,0,0
0,0,0,0,0,0,0,0,0,0,0
0,0,0,0,0,0,0,0,0,0,0
0,0,0,0,0,0,0,0,0,0,0
0,0,0,0,0,0,0,0,0,0,0
0,0,0,0,0,0,0,0,0,0,0
0,0,0,0,0,0,0,0,0,0,0
0,0,0,0,0,0,0,0,0,0,0
0,0,0,0,0,0,0,0,0,0,0
0,0,0,0,0,0,0,0,0,0,0
0,0,0,0,0,0,0,0,0,0,0
0,0,0,0,0,0,0,0,0,0,0
0,0,0,0,0,0,0,0,0,0,0
0,0,0,0,0,0,0,0,0,0,0
0,0,0,0,0,0,0,0,0,0,0
0,0,0,0,0,0,0,0,0,0,0
0,0,0,0,0,0,0,0,0,0,0
0,0,0,0,0,0,0,0,0,0,0
0,0,0,0,0,0,0,0,0,0,0
0,0,0,0,0,0,0,0,0,0,0
0,0,0,0,0,0,0,0,0,0,0
0,0,0,0,0,0,0,0,0,0,0
0,0,0,0,0,0,0,0,0,0,0
0,0,0,0,0,0,0,0,0,0,0
0,0,0,0,0,0,0,0,0,0,0
0,0,0,0,0,0,0,0,0,0,0
0,0,0,0,0,0,0,0,0,0,0
0,0,0,0,0,0,0,0,0,0,0
0,0,0,0,0,0,0,0,0,0,0
0,0,0,0,0,0,0,0,0,0,0
0,0,0,0,0,0,0,0,0,0,0
0,0,0,0,0,0,0,0,0,0,0
0,0,0,0,0,0,0,0,0,0,0
0,0,0,0,0,0,0,0,0,0,0
0,0,0,0,0,0,0,0,0,0,0
0,0,0,0,0,0,0,0,0,0,0
0,0,0,0,0,0,0,0,0,0,0
0,0,0,0,0,0,0,0,0,0,0
0,0,0,0,0,0,0,0,0,0,0
17,18,19,20,21,22,23,24
33,34,35,36,37,38,39,40
45.46.47.48
50,51,52,53,54,55,56,57
17,18,19,20,21,22,23,24
33,34,35,36,37,38,39,40
45.46.47.48
50,51,52,53,54,55,56,5717,18,19,20,21,22,23,24
33,34,35,36,37,38,39,40
45.46.47.48
50,51,52,53,54,55,56,5717,18,19,20,21,22,23,24
33,34,35,36,37,38,39,40
45.46.47.48
50,51,52,53,54,55,56,5717,18,19,20,21,22,23,24
33,34,35,36,37,38,39,40
45.46.47.48
50,51,52,53,54,55,56,5717,18,19,20,21,22,23,24
33,34,35,36,37,38,39,40
45.46.47.48
50,51,52,53,54,55,56,5717,18,19,20,21,22,23,24
33,34,35,36,37,38,39,40
45.46.47.48
50,51,52,53,54,55,56,5717,18,19,20,21,22,23,24
33,34,35,36,37,38,39,40
45.46.47.48
50,51,52,53,54,55,56,5717,18,19,20,21,22,23,24
33,34,35,36,37,38,39,40
45.46.47.48
50,51,52,53,54,55,56,5717,18,19,20,21,22,23,24
33,34,35,36,37,38,39,40
45.46.47.48
50,51,52,53,54,55,56,5717,18,19,20,21,22,23,24
33,34,35,36,37,38,39,40
45.46.47.48
50,51,52,53,54,55,56,5717,18,19,20,21,22,23,24
33,34,35,36,37,38,39,40
45.46.47.48
50,51,52,53,54,55,56,5717,18,19,20,21,22,23,24
33,34,35,36,37,38,39,40
45.46.47.48
50,51,52,53,54,55,56,5717,18,19,20,21,22,23,24
33,34,35,36,37,38,39,40
45.46.47.48
50,51,52,53,54,55,56,5717,18,19,20,21,22,23,24
33,34,35,36,37,38,39,40
45.46.47.48
50,51,52,53,54,55,56,5717,18,19,20,21,22,23,24
33,34,35,36,37,38,39,40
45.46.47.48
50,51,52,53,54,55,56,5717,18,19,20,21,22,23,24
33,34,35,36,37,38,39,40
45.46.47.48
50,51,52,53,54,55,56,5717,18,19,20,21,22,23,24
33,34,35,36,37,38,39,40
45.46.47.48
50,51,52,53,54,55,56,5717,18,19,20,21,22,23,24
33,34,35,36,37,38,39,40
45.46.47.48
50,51,52,53,54,55,56,5717,18,19,20,21,22,23,24
33,34,35,36,37,38,39,40
45.46.47.48
50,51,52,53,54,55,56,5717,18,19,20,21,22,23,24
33,34,35,36,37,38,39,40
45.46.47.48
50,51,52,53,54,55,56,5717,18,19,20,21,22,23,24
33,34,35,36,37,38,39,40
45.46.47.48
50,51,52,53,54,55,56,5717,18,19,20,21,22,23,24
33,34,35,36,37,38,39,40
45.46.47.48
50,51,52,53,54,55,56,5717,18,19,20,21,22,23,24
33,34,35,36,37,38,39,40
45.46.47.48
50,51,52,53,54,55,56,5717,18,19,20,21,22,23,24
33,34,35,36,37,38,39,40
45.46.47.48
50,51,52,53,54,55,56,5717,18,19,20,21,22,23,24
33,34,35,36,37,38,39,40
45.46.47.48
50,51,52,53,54,55,56,5717,18,19,20,21,22,23,24
33,34,35,36,37,38,39,40
45.46.47.48
50,51,52,53,54,55,56,5717,18,19,20,21,22,23,24
33,34,35,36,37,38,39,40
45.46.47.48
50,51,52,53,54,55,56,5717,18,19,20,21,22,23,24
33,34,35,36,37,38,39,40
45.46.47.48
50,51,52,53,54,55,56,5717,18,19,20,21,22,23,24
33,34,35,36,37,38,39,40
45.46.47.48
50,51,52,53,54,55,56,5717,18,19,20,21,22,23,24
33,34,35,36,37,38,39,40
45.46.47.48
50,51,52,53,54,55,56,5717,18,19,20,21,22,23,24
33,34,35,36,37,38,39,40
45.46.47.48
50,51,52,53,54,55,56,5717,18,19,20,21,22,23,24
33,34,35,36,37,38,39,40
45.46.47.48
50,51,52,53,54,55,56,5717,18,19,20,21,22,23,24
33,34,35,36,37,38,39,40
45.46.47.48
50,51,52,53,54,55,56,5717,18,19,20,21,22,23,24
33,34,35,36,37,38,39,40
45.46.47.48
50,51,52,53,54,55,56,5717,18,19,20,21,22,23,24
33,34,35,36,37,38,39,40
45.46.47.48
50,51,52,53,54,55,56,5717,18,19,20,21,22,23,24
33,34,35,36,37,38,39,40
45.46.47.48
50,51,52,53,54,55,56,5717,18,19,20,21,22,23,24
33,34,35,36,37,38,39,40
45.46.47.48
50,51,52,53,54,55,56,5717,18,19,20,21,22,23,24
33,34,35,36,37,38,39,40
45.46.47.48
50,51,52,53,54,55,56,5717,18,19,20,21,22,23,24
33,34,35,36,37,38,39,40
45.46.47.48
50,51,52,53,54,55,56,5717,18,19,20,21,22,23,24
33,34,35,36,37,38,39,40
45.46.47.48
50,51,52,53,54,55,56,5717,18,19,20,21,22,23,24
33,34,35,36,37,38,39,40
45.46.47.48
50,51,52,53,54,55,56,5717,18,19,20,21,22,23,24
33,34,35,36,37,38,39,40
45.46.47.48
50,51,52,53,54,55,56,5717,18,19,20,21,22,23,24
33,34,35,36,37,38,39,40
45.46.47.48
50,51,52,53,54,55,56,5717,18,19,20,21,22,23,24
33,34,35,36,37,38,39,40
45.46.47.48
50,51,52,53,54,55,56,5717,18,19,20,21,22,23,24
33,34,35,36,37,38,39,40
45.46.47.48
50,51,52,53,54,55,56,5717,18,19,20,21,22,23,24
33,34,35,36,37,38,39,40
45.46.47.48
50,51,52,53,54,55,56,5717,18,19,20,21,22,23,24
33,34,35,36,37,38,39,40
45.46.47.48
50,51,52,53,54,55,56,5717,18,19,20,21,22,23,24
33,34,35,36,37,38,39,40
45.46.47.48
50,51,52,53,54,55,56,5717,18,19,20,21,22,23,24
33,34,35,36,37,38,39,40
45.46.47.48
50,51,52,53,54,55,56,5717,18,19,20,21,22,23,24
33,34,35,36,37,38,39,40
45.46.47.48
50,51,52,53,54,55,56,57
60,,61,62,63,64,65,66
0,0,0,0,0,0,0,0,0,0
0,0,0,0,0,0,0,0,0,0,0
0,0,0,0,0,0,0,0,0,0,0
0,0,0,0,0,0,0,0,0,0,0
0,0,0,0,0,0,0,0,0,0,0
0,0,0,0,0,0,0,0,0,0,0
0,0,0,0,0,0,0,0,0,0,0
0,0,0,0,0,0,0,0,0,0,0
0,0,0,0,0,0,0,0,0,0,0
0,0,0,0,0,0,0,0,0,0,0
0,0,0,0,0,0,0,0,0,0,0
0,0,0,0,0,0,0,0,0,0,0
0,0,0,0,0,0,0,0,0,0,0
0,0,0,0,0,0,0,0,0,0,0
0,0,0,0,0,0,0,0,0,0,0
0,0,0,0,0,0,0,0,0,0,0
0,0,0,0,0,0,0,0,0,0,0
0,0,0,0,0,0,0,0,0,0,0
0,0,0,0,0,0,0,0,0,0,0
0,0,0,0,0,0,0,0,0,0,0
0,0,0,0,0,0,0,0,0,0,0
0,0,0,0,0,0,0,0,0,0,0
0,0,0,0,0,0,0,0,0,0,0
0,0,0,0,0,0,0,0,0,0,0
0,0,0,0,0,0,0,0,0,0,0
0,0,0,0,0,0,0,0,0,0,0
0,0,0,0,0,0,0,0,0,0,0
0,0,0,0,0,0,0,0,0,0,0
0,0,0,0,0,0,0,0,0,0,0
0,0,0,0,0,0,0,0,0,0,0
0,0,0,0,0,0,0,0,0,0,0
0,0,0,0,0,0,0,0,0,0,0
0,0,0,0,0,0,0,0,0,0,0
0,0,0,0,0,0,0,0,0,0,0
0,0,0,0,0,0,0,0,0,0,0
0,0,0,0,0,0,0,0,0,0,0
0,0,0,0,0,0,0,0,0,0,0
0,0,0,0,0,0,0,0,0,0,0
0,0,0,0,0,0,0,0,0,0,0
0,0,0,0,0,0,0,0,0,0,0
0,0,0,0,0,0,0,0,0,0,0
0,0,0,0,0,0,0,0,0,0,0
0,0,0,0,0,0,0,0,0,0,0
0,0,0,0,0,0,0,0,0,0,0
0,0,0,0,0,0,0,0,0,0,0
0,0,0,0,0,0,0,0,0,0,0
0,0,0,0,0,0,0,0,0,0,0
0,0,0,0,0,0,0,0,0,0,0
0,0,0,0,0,0,0,0,0,0,0
0,0,0,0,0,0,0,0,0,0,0
0,0,0,0,0,0,0,0,0,0,0
0,0,0,0,0,0,0,0,0,0,0
0,0,0,0,0,0,0,0,0,0,0
0,0,0,0,0,0,0,0,0,0,0
0,0,0,0,0,0,0,0,0,0,0
0,0,0,0,0,0,0,0,0,0,0
0,0,0,0,0,0,0,0,0,0,0
0,0,0,0,0,0,0,0,0,0,0
0,0,0,0,0,0,0,0,0,0,0
0,0,0,0,0,0,0,0,0,0,0
0,0,0,0,0,0,0,0,0,0,0
0,0,0,0,0,0,0,0,0,0,0
0,0,0,0,0,0,0,0,0,0,0
0,0,0,0,0,0,0,0,0,0,0
0,0,0,0,0,0,0,0,0,0,0
0,0,0,0,0,0,0,0,0,0,0
0,0,0,0,0,0,0,0,0,0,0
0,0,0,0,0,0,0,0,0,0,0
0,0,0,0,0,0,0,0,0,0,0
0,0,0,0,0,0,0,0,0,0,0
0,0,0,0,0,0,0,0,0,0,0
0,0,0,0,0,0,0,0,0,0,0
0,0,0,0,0,0,0,0,0,0,0
0,0,0,0,0,0,0,0,0,0,0
0,0,0,0,0,0,0,0,0,0,0

